###########
#S...#....#
#.#.#.##..#
#.#......E#
#..##.##..#
###########

